1111111111111111111111111
1000000000000000000000001
1000000000000000000000001
1000000000000000000000001
1000000110000000000000001
1000000000000000000000001
1000000000000000000000001
1000011110000000000000001
1000011110000000000011001
1000000000011110000000001
1000000000111110000011101
1000000000000000000000001
1000000000001100000000001
1000000000011111100000001
1000000000001100000000001
1000000000000000000000001
1000000000000000000000001
1000000000001111111000001
1000001100000000000000001
1000000001111111111000001
1000000000000000000000001
1000000000000000000111101
1000000011000000000000001
1000000000000000000000001
1111111111111111111111111
